             
 . . . . . .S
   - -     - 
 . .|. .|. . 
         -   
 . .|.|. H|. 
 -   - - -   
 .|.|. . . . 
       -   - 
 . .|. E .|. 
   -         
 . . . . M . 
             